||||||||||||||||||||||||||
|####~|||####|###########|
|####~~||#####|##########|
|#####~~|#####|##########|
|######~|#####|##########|
|~~#####|#####|#####||||||
||~~##########||#########|
|||~~#########|##########|
|##|||########||||||#####|
|##########|####~~~|#####|
|##########|#############|
|##########|#############|
||||||||###|||||||||||###|
|~~~~~~|#######|~~#######|
|~~####|#######|~########|
|######|#######|~########|
||||###|#######|||#######|
|##|###|#################|
|###################$$$$#|
|~##################$$$$#|
||||||||||||||||||||||||||