||||||||||||||||||||||||||
|####~||######|##########|
|####~~||#####|##########|
|#####~~|#####|##########|
|######~|#####|##########|
|~~#####|#####|#####||||||
||~~##########|##########|
|||~~#########|##########|
|#||||########||||||#####|
|####|#####|####~~~|#####|
|##########|#############|
|##########|#############|
||||||||###|||||||||||###|
|~~~~~~|#######|~~#######|
|~~####|#######|~########|
|######|#######|~########|
||||###|#######|||#######|
|##|###|#################|
|###################$$$$#|
|~##################$$$$#|
||||||||||||||||||||||||||