||||||||||||||||||||||||||||
|###########|~~~##########@|
|###########|######+#######|
|####||||###|######|#######|
|######+|###|######|||||###|
|##################|~######|
|##################|~######|
|||||||||######|||||||#+#|||
|~~~~##############~~|####~|
|~#+###############+~|####~|
|~##########|########|####~|
|~##########|~~~###|||#####|
|#######||||||||####|~###+#|
|##############|#####|~~~##|
|##############|#####|||~@#|
|##|||########~|#######|||||
|+##~|#######+~|###########|
|####|#####~~~~|###########|
|####|####|||||||||########|
|####||###+#######|########|
|####|~##########@|##$$$$##|
|~~~~|~~~~~~~~~~~~|##$$$$##|
||||||||||||||||||||||||||||