|||||||||||||||||||||||
|####~||#########|~~~~|
|####~~|||#######|~###|
|#####~~|#####|##||###|
|######~|#####|#######|
|~~#####|#####|#######|
||~~##########|#######|
|||~~#########|#######|
|#||||########|||||||||
|####|#####|######~~~~|
|##########|#########~|
|##########|##########|
||||||||###||||||||||||
|~~~~~~|#######|~~####|
|~#####|#######|~#####|
|######|#######|~#####|
|##|###|#######|||####|
|##|###|##############|
|#################$$$$|
|~################$$$$|
|||||||||||||||||||||||