||||||||||||||||||||||||||
|####~||#########|~~~~###|
|####~~|||#######|~######|
|#####~~|#####|##||######|
|######~|#####|##########|
|~~#####|#####|##########|
||~~##########|##########|
|||~~#########|##########|
|#||||########||||||||###|
|####|#####|######~~~~###|
|##########|#########~###|
|##########|#############|
||||||||###|||||||||||###|
|~~~~~~|#######|~~#######|
|~#####|#######|~########|
|######|#######|~########|
|##|###|#######|||#######|
|##|###|#################|
|#################$$$$###|
|~################$$$$###|
||||||||||||||||||||||||||