||||||||||||||||||||||||||
|####~||@#####|#########@|
|####~~|#+####|##+|||####|
|#####~~|#####|##########|
|######~|#####|##########|
|~~#####|#####|###+|||||||
||~~##########|##########|
|||~~###+#####|##########|
|@#|||########||||||#####|
|#+##|#####|####~~~|#####|
|##########|#############|
|##########|+############|
||||||||###|||||||||||###|
|@~~~~~|#####+#|~~+######|
|~~####|#######|~########|
|######|#######|~########|
||||###|#######|||#######|
|##|###|#################|
|##########||#######$$$$#|
|~##########+#######$$$$#|
||||||||||||||||||||||||||