||||||||||||||||||||||||||
|######|~~~~~~~|#~@~#|~~~|
|######|+#####~|##|##|##@|
|######|#######|##+##|###|
|#####~|#######|#####|###|
|~#####|###|###|#########|
|~#####|###|############~|
|~#####|################+|
|~####~|#######|~#######~|
|+####~|###|#########|###|
|#####~|#############|###|
|#####~|#######|#####|###|
|##############|#####|###|
|##############|~###~|##~|
|######|+######|~###~|##~|
|##########|###|~~~~~~~~~|
|##############|~########|
|#+##~~|###+###|~########|
|###||||###|###|~########|
|#####@|###@###|~###$$$$#|
|#####~|~~~~~~~|~###$$$$#|
||||||||||||||||||||||||||