\\\\\\\\\\\\\\\\\\\\\\\\\\
|########################|
|$$$$$$$$$$$$$$$$$$$$$$$$|
|$$$$$$$$$$$$$$$$$$$$$$$$|
|&&&&&&&&&&&&&&&&&&&&&&&&|
|~~~~~~~~~~~~~~~~~~~~~~~~|
|$$$$$$$$$$$$$$$$$$$$$$$$|
|########################|
|$$$$$$$$$$$$$$$$$$$$$$$$|
|$$$$$$$$$$$$$$$$$$$$$$$$|
|&&&&&&&&&&&&&&&&&&&&&&&&|
\\\\\\\\\\\\\\\\\\\\\\\\\\