||||||||||||||||||||||||||||
|###########|~~~###########|
|###########|##############|
|#####|||###|##############|
|#######|###|######|||||###|
|##################|~######|
|##################|~######|
|||||||||######|||||||###|||
|~~~~##############~~|####~|
|~##################~|####~|
|~##########|########|####~|
|~##########|~~~###|||#####|
|#######||||||||####|~#####|
|##############|#####|~~~##|
|##############|#####|||~##|
|##|||########~|#######|||||
|###~|########~|###########|
|####|########~|###########|
|####|#####~~~~|###########|
|####||###|||||||||########|
|####|~##########+|########|
|####|~###########|##$$$$##|
|~~~~|~~~~~~~~~~~~|##$$$$##|
||||||||||||||||||||||||||||